#####B#
#     #
# ## ##
# ## ##
#    ##
#A#####